XXXXXXX XXXXXXX
X   X         X
X X X XXXXXXX X
X X X X   X   X
X X X XXX X XXX
X X X X   X   X
XXX X X X XXX X
X   X   X   X X
X XXXXXXXXX XXX
X       X   X X
X XXXXX X XXX X
X X   X   X   X
X XXX XXXXX X X
X           X X
XXXXXXX XXXXXXX
